meta:width=72
meta:height=24
meta:name=Bastok Mines
layer:terrain
####################################################WWWWWWW............
#.............................................WWWWW####################
#..........................................WWWWWW###..................#
#..........................................WWWWW##....................#
#..........................................WWWWW#.....................#
#..........................................WWWWW#...........#.........#
#..........................................WWWWW#...........#..........
#..........................................=====............#..........
#..........................................=====............#..........
#..........................................WWWWW#...........#.........#
#..........................................WWWWW#...........#.........#
#.........................................#######.....................#
#........................................##.... ##....................#
#.......................................##.......##...................#
#......................................##.........#####################
#..............####..####.....####....##...............................
#.............##........##..###..###.##................................
#.............#..........####......###.................................
#.............#..........#..........##.................................
#...WWW.......#....................###.................................
#...WWW.......#...................###..................................
#.........#####..........#...#####WWWWWWWWWWWWW........................
####...####...################WWWWWWWWWWWWWWWWW........................