meta:width=72
meta:height=24
meta:name=Bastok Mines
layer:terrain
####################################################...................
#..................................................####################
#................................................###..................#
#...............................................##....................#
#...............................................#.....................#
#...............................................#...........#.........#
#...............................................#...........#..........
#...........................................................#..........
#...........................................................#..........
#...............................................#...........#.........#
#...............................................#...........#.........#
#.........................................#######.....................#
#........................................##.... ##....................#
#.......................................##.......##...................#
#......................................##.........#####################
#..............####..####.....####....##...............................
#.............##........##..###..###.##................................
#.............#..........####......###.................................
#.............#..........#..........##.................................
#.............#....................###.................................
#.............#..................###.#.................................
#.........#####..........#...#####...#.................................
####...####...################.......#.................................