meta:width=54
meta:height=16
% San d'Oria
layer:terrain
######################################################
#....................................................#
#.........................###........................#
#.........................#.#........................#
#.........................#.#........................#
#....................................................#
#....................................................#
#....................................................#
#....................................................#
#....................................................#
#....................................................#
#....................................................#
#....................................................#
#....................................................#
#....................................................#
######################################################
