meta:width=108
meta:height=32
meta:name=Test Scroll Zone
exit:x=0,y=16,file=bastok.map,tx=52,ty=8
layer:terrain
############################################################################################################
#..........................................................................................................#
#..........................................................................................................#
#..........................................................................................................#
#..........................................................................................................#
#..........................................................................................................#
#..........................................................................................................#
#..........................................................................................................#
#..........................................................................................................#
#..........................................................................................................#
#..........................................................................................................#
#..........................................................................................................#
#..........................................................................................................#
#..........................................................................................................#
#..........................................................................................................#
#..........................................................................................................#
...........................................................................................................#
#..........................................................................................................#
#..........................................................................................................#
#..........................................................................................................#
#..........................................................................................................#
#..........................................................................................................#
#..........................................................................................................#
#..........................................................................................................#
#..........................................................................................................#
#..........................................................................................................#
#..........................................................................................................#
#..........................................................................................................#
#..........................................................................................................#
#..........................................................................................................#
#..........................................................................................................#
############################################################################################################
